1111111111111111111111111111111111111111111111111111111111111111111111111111111111420031111111111111111111111111111111111111111111111111111111111111111111111111111111111
1111111111111111100111111111000000000111100000001111110201100311111000000011111140000000011110000000111111020110031111100000001111110000000001111110011111111111111111111
1111111111111111110000111111111014011111111002001111111310100111111100000011111110011101111111111112111111130000001111111111000111111111110011111111111011111111111111111
1111111111111111111111111111111111111111111111111111111111111111111111111111110020411130000111111111111111111111111111111111111111111111111111111111111111111111111111111
3111100000001111110011100111111101111111111110111111111100000111111110000011110000002400000111100000111111110000011111111110111111011111011111001111101110000111110111001
0300000000300003000000300000002030002000000000000000000004000200000000000000000000000000000000000000000000000000000003000010002000300020000000000000000330001200013100300
